a	了 的时候 ① 什么 但是
aa	候 任何 到了
ab	巴
ac	传
ad	保
af	但 但是 做出
ag	何
ah	做
ai	使
aj	今
ak	什
al	着 你们
am	您
an	作 安 ① 案
ao	仍
ap	住
aq	仅
ar	体
as	美 到达
at	像 似乎
au	便 今天
av	留 仍然
aw	们
ay	低 你好 例如
az	侧
b	里 ① 月 应该 里面
ba	府
bb	朋
bc	突
bd	腰
bf	店
bg	广
bh	应
bi	度
bj	空
bk	万
bl	收
bm	胜
bn	脸
bo	养
bp	野
bq	服
br	床
bs	穿
bt	拳
bu	胸
bv	究 突然
bw	脚
by	底
bz	脑
c	几 ① 种 几个 灵魂
ca	专
cb	青
cc	毒
cd	程
cf	香 ① ② 神
cg	秘
ch	风
ci	支
cj	几
ck	习
cl	段
cm	母
cn	灵
co	利
cp	表
cq	帮
cr	痛
cs	示
ct	群
cu	病
cv	科
cw	社
cy	委
cz	责
d	和 ① ② 只是 别人
da	吧
db	叫 哪里
dc	票
dd	品 ① ② 哭 只要
df	喝
dg	吗 哪怕
dh	和
di	口
dj	别
dk	西 只有 吃饭
dl	两
dm	只
dn	哈 只会
do	哪
dp	吸
dq	啊
dr	呆
ds	呀
dt	啦
du	号 哪一
dv	嘴 虽然
dw	吐
dy	由
dz	听
ea	！
ef	、
ei	？”
ej	“
ek	”
el	；
eo	‘
ep	’
eq	：“
es	……
eu	。”
ew	？
f	是 上 ① 时候 出来
fa	题 得到 遇到 最差
fb	明
fc	状
fd	点
ff	得 晚点
fg	影 明白
fh	交
fi	北
fj	易 很少 出发
fk	时
fl	行 出现 往
fm	晚
fn	遇
fo	日
fp	最
fq	径
fr	果
fs	山 时刻
ft	晓
fu	量 明天 昨天
fv	将 上来 很多
fw	待 时间 最坏
fy	出 最好
fz	很 电话
g	的 就 ① 自己 就是
ga	速
gb	白
gc	情
gd	必
gf	慢 可是
gg	高 慢慢
gh	熟
gi	心 可以 的事
gj	京 敢
gk	可
gl	整
gm	马
gn	并 整个 的人 就会
go	自 就算
gp	亮
gq	怪
gr	惨 可能 就能
gs	束
gt	必 熟悉 自我
gu	快
gv	鼻 自然 情况
gw	忙 必须
gy	用 就好
gz	恨 的话
h	子 后 学 觉得 原来
ha	连 身体
hb	胡
hc	转
hd	儿
hf	较
hg	原 爱情
hh	克
hi	顾 故事
hj	错 反而
hk	希
hl	龙
hm	举
hn	输 学会
ho	果 原因
hp	爱
hq	轻
hr	杀
hs	身 后面
ht	铁
hu	钱 后天
hv	舞
hw	觉
hy	凶
hz	银 错误
i	没 以 事 没有 已经
ia	引 导致
ib	深
ic	清
id	强
if	方 每日
ig	济 事情
ih	湖 以后 比较
ii	已
ij	己 弱小
ik	导 放在
il	放 注
im	豆 以前
in	淡 每个
io	世
ip	活 以为
iq	汉
ir	流
is	水 强大 异常
it	年
iu	张 每天
iv	副 世界 以来 复杂
iw	法
iy	洞 毕竟 比如
iz	白
j	这 小 发 这个 这样
ja	边 工作 当你
jb	散 这里
jc	当 这种
jd	加
jf	莫 幕 这是 而是 力量 早点
jg	工 恐怖 这就
jh	苦
ji	落 而已 办法
jj	功
jk	若 而且
jl	力 发现
jm	办 发生
jn	警
jo	艺
jp	带
jq	节
jr	而
js	四
jt	少 这么 当我
ju	著 这一 带走
jv	罗 这些 当然 带来
jw	文
jy	英
jz	早
k	有 在 才 所以 有点
ka	过 即使
kb	即
kc	微 各种
kd	右
kf	春 有时
kg	各 真的
kh	教
ki	求
kj	左
kk	真 所有
kl	老
km	具 十分
kn	机
ko	布
kp	索
kq	友 考虑
kr	将 才能
ks	十
kt	载 直接
ku	考 真正 过于
kv	博 有些 过来
kw	维 过去
ky	南
kz	所
l	他 你 现 现在 睡觉
la	特 他们 ① 迟
lb	重
lc	睛
ld	中 ① ② 臂 壁
lf	处 光明
lg	光 他的 你的
lh	居
li	尼
lj	展
lk	球
ll	眉 眼睛
lm	目
ln	珍
lo	玩 尽管
lp	玉
lq	千
lr	条
ls	与
lt	属
lu	环 属于
lv	备 尽 居然
lw	王
ly	言
lz	眼
m	到 道 生 生活 终于
ma	色
mb	前
mc	急
md	总 总要
mf	单 总是 结果
mg	解 结束
mh	父
mi	纪 生活
mj	并
mk	组 并且
ml	终
mm	分 曾经 纷纷
mn	给
mo	弟
mp	级
mq	经
mr	公 普通 总想
ms	关 经常 前面
mt	半
mu	约 前天
mv	曾 解决 判断
mw	结
my	纸
mz	负
n	人 个 会 怎么 其实
na	进 其他 甚至
nb	期
nc	余
nd	合
nf	火 平时
ng	怎
nh	剑
ni	创
nj	句
nk	宝
nl	全
nm	平 人生
nn	从 与其 众人
no	甚
np	舍 其它 其实
nq	其
nr	会
ns	谁 全部 创造
nt	建
nu	入
nv	企
nw	基
ny	与
nz	斯
o	那 国 回 因为 那个
oa	提
ob	内 那里
oc	归 那种
od	圆
of	飞 那是
og	共 迅速 那就
oh	远
oi	司
oj	们
ok	团
ol	算
om	主 简单
on	答
oo	第
op	管
oq	紧
or	二 那样 困难
os	因
ot	笑 那么
ou	师 那一
ov	买 那些 因此
ow	等
oy	业
oz	费
p	为 家 定 喜欢 容易
pa	室 为了
pb	官
pc	害
pd	喜
pf	夫
pg	被 容 害怕
ph	字 完
pi	它
pj	及 实力 适当
pk	客
pl	主
pm	联
pn	写 完全 适合
po	完 永远
pp	农
pq	取
pr	耳 完成
ps	赛
pt	柔 乱
pu	宁
pv	实
pw	规
py	安
pz	良
q	对 又 ① 东西 对方
qa	鲜 虚假
qb	阴
qc	际
qd	鸡
qf	阳
qg	阿 限 ① 艰
qh	阵 对错
qi	该
qj	东
qk	随
ql	欢
qm	切 陌生
qn	队 麻烦
qo	虚
qp	院
qq	双
qr	集
qs	陪 对面
qt	戏
qu	卫 对于
qv	鱼
qw	观
qy	魔
qz	限
r	能 想 ① 感觉 想要
ra	样 相信
rb	育
rc	机
rd	台
rf	查
rg	通
rh	李 本身
ri	感 枝
rj	动 成功
rk	格
rl	相
rm	毛
rn	难 能够
ro	成
rp	极 成为
rq	权
rr	林
rs	参 标
rt	桥
ru	本
rv	楼 本来
rw	杜
ry	云
rz	根
s	大 也 ① 需要 大家
sa	达 达到
sb	童
sc	雪
sd	部 特别
sf	站 也是 特点 路上
sg	奇
sh	先 之后
si	之
sj	物 太少
sk	路 也有
sl	立
sm	面 之前 面前
sn	牛 足够
so	常
sp	太
sq	气 面对
sr	新 ，露台 大概
ss	露 立刻
st	掌 选择
su	足
sv	雷 太多
sw	特
sy	制
sz	跟 也许 告诉
t	我 么 ① 我们 看到
ta	把
tb	追
tc	技
td	或
tf	提
tg	拍 我的
th	摇 接受
ti	指 技
tj	式
tk	象
tl	看
tm	系 拒绝
tn	势
to	根
tp	失
tq	报
tr	抬
ts	手
tt	找
tu	打 或者
tv	翻
tw	持
ty	向
tz	折 或许 失败
u	一 不 要 一个 不是
ua	还
ub	丽
uc	长 一种
ud	知 不要 还要
uf	下 还是 一点 于是 都是
ug	百 不怕 不懂 不必
uh	区 不错
ui	起 无法 无比
uj	开 不少 更加 更少
uk	于 还有 一直 都有 都在
ul	遭
um	万 知道
un	赶 不够 长期 短期 不与
uo	亚 不敢
up	趣 一定 确实 确定
uq	都 一切
ur	越 一样 不能 不想
us	天 正常 不跟
ut	武
uu	无 一起 正确 不再
uv	正 一些 一般 起来 下来 更多 不止
uw	走 再见
uy	再 开始 不同
uz	碎 无论
v	来 然 ② 然后 为什么
va	冷 来到
vb	肯
vc	精
vd	名
vf	外 此时 黑暗
vg	思
vh	黑
vi	此
vj	男 然而
vk	变
vl	次
vm	米
vn	界
vo	断
vp	久 名字
vq	准
vr	杂
vs	头 外面 此刻
vt	田 多么
vu	决
vv	多 未来
vw	未
vy	数
vz	开
w	去 地 ① 问题 地方
wa	须 见到
wb	望
wc	款
wd	问
wf	间 却将
wg	志
wh	土
wi	死 增强
wj	见
wk	入
wl	声
wm	门
wn	闪 尤其
wo	场
wp	闻
wq	餐
wr	却
ws	士
wt	域 却把
wu	块
wv	卖
ww	封
wy	境 声音
wz	闹 忘记
y	她 好 如 如果 意思
ya	确 好像 如何 她们
yb	女
yc	妇
yd	嫌
yf	非 同时
yg	意 她的
yh	刚
yi	同 逐渐
yj	妙
yk	姐
yl	欲
ym	姓 始终
yn	内
yo	奶
yp	娘
yq	怒
yr	始
ys	三 非常
yt	明
yu	缺
yv	妹 竟然 如此
yw	周
yy	音
yz	丹
z	说 ① 话 记得 说话
za	近
zb	贝
zc	请
zd	识
zf	让 变得
zg	语
zh	离
zi	记
zj	金
zk	计
zl	设
zm	民
zn	认
zo	市
zp	议
zq	即
zr	诚 变成
zs	该
zt	试
zu	证 离开
zv	谓 许多 既然 读
zw	读
zy	调
zz	诉