他	l
你	le
中	ld
到	m
要	ux
们	oj
开	vz
主	om
明	yt
与	ls
将	kr
果	ho
机	kn
白	iz
内	ob
入	wk
并	gn
特	la
该	qi
万	bk
变	vk
提	oa
必	gd
即	kb
确	ya
根	to
读	zvs
标	rse
完	phe
限	qge
艰	qg;
宝	nk
枝	rie
技	tie
尽	lve
迟	la;
注	ile
容	pge
乱	pte
安	ane
案	an;
往	flx
探	tnr
延	tmt
药	jvu
君	cyd