他	l	1	调
你	l	2	调
中	ld
到	m	1	调
要	u	3
话	f	3
们	oj
开	vz
主	om
者	of
直	vn
明	yt
与	ls
将	kr
更	kf
果	ho
机	kn
白	iz
内	ob
入	wk
并	gn
特	la
该	qi
万	bk
变	vk
提	oa
必	gd
即	kb
确	ya
根	to
读	zv	4
标	rs
完	ph
限	qg
艰	qg
宝	nk
枝	ri
技	ti
尽	lv
迟	la	4
注	il
容	pg
乱	pt
安	an
案	an
往	fl	3
探	tnr
延	tmt
药	jvu
君	cyd
敢	gj